+---------+
|R: | : : |
| : | : : |
| : : : : |
| | : | : |
|G| : | : |
+---------+