+---------+
| : | : :R|
| : | : | |
| : | : | |
| | | : : |
| |G: | : |
+---------+