+---------+
| : | : : |
| : | : : |
| : : : : |
| | : | : |
|G| :R| : |
+---------+