+---------+
| : |R| :G|
| : | | : |
| : : : : |
| | : | : |
| | : | : |
+---------+