+---------+
| : | : : |
| :G| : : |
| : | : : |
| | | : | |
| | : : |R|
+---------+