+---------+
| : | : :G|
| : | : : |
| : : : : |
| | : | : |
|R| : | : |
+---------+