+---------+
| : | : | |
| : : : : |
|R| : : : |
| | : | : |
| | :G| : |
+---------+