+---------+
| : | : |G|
| : : : : |
| : : | : |
| | : | : |
| | :R| : |
+---------+