+---------+
|R: | : : |
| : | : : |
| : : : : |
| | : | : |
| | : | :G|
+---------+