+---------+
|R: | : :G|
| : | : : |
| : : : : |
| | : | : |
| | : | : |
+---------+